@############################@
#                            #
#                         #  #
#                         #  #
#                         #  #
#      @@@@               #  #
#                         #  #
#         F               #  #
#                         #  #
#                         #  #
#                         #  #
#                            #
#                            #
#                            #
#                  P         #
#              O             #
#              o             #
#              o             #
#      #                     #
#      #                     #
#      #                     #
#      #                     #
#      #                     #
#      #                     #
#      @########             #
#                            #
#                            #
#                            #
#                            #
@############################@