@############################@
#            F               #
#                            #
#                            #
#                            #
#                            #
#                            #
#                            #
#                            #
#                            #
#                            #
#                            #
#                     P      #
#                            #
#                            #
#              O             #
#              o             #
#              o             #
#              o             #
#                            #
#                            #
#                            #
#                            #
#                            #
#                            #
#                            #
#                            #
#                            #
#                            #
@############################@